         
            
            0, 0, 0, 0, 0, 0, 0, 0, 0, 0, 0, 0, 0, 0, 0, 0, 0, 0, 0, 0, 0, 0, 0, 0, 0,
            0, 0, 0, 0, 0, 0, 0, 0, 0, 0, 0, 0, 0, 0, 0, 0, 1, 1, 0, 0, 0, 0, 0, 0, 0,
            0, 0, 0, 0, 0, 0, 0, 0, 0, 0, 0, 0, 0, 0, 0, 0, 0, 1, 1, 0, 0, 0, 0, 1, 0,
            0, 0, 0, 0, 0, 0, 0, 0, 0, 0, 0, 0, 0, 0, 0, 0, 0, 0, 1, 1, 0, 0, 0, 1, 1,
            0, 0, 0, 0, 0, 0, 0, 0, 0, 1, 0, 0, 0, 0, 0, 0, 0, 0, 0, 1, 0, 0, 0, 0, 1,
            0, 0, 0, 0, 0, 0, 0, 0, 1, 0, 0, 0, 0, 0, 0, 0, 0, 0, 0, 0, 0, 0, 0, 0, 1,
            0, 0, 0, 0, 0, 0, 0, 0, 1, 0, 0, 0, 0, 0, 0, 0, 0, 0, 0, 0, 0, 0, 0, 0, 1,
            0, 0, 0, 0, 0, 0, 0, 1, 1, 0, 0, 0, 0, 0, 0, 0, 0, 0, 0, 0, 0, 0, 0, 0, 0,
            0, 0, 0, 0, 0, 0, 1, 1, 0, 0, 0, 0, 0, 0, 0, 0, 0, 0, 0, 0, 0, 0, 1, 0, 0,
            0, 0, 0, 0, 0, 0, 1, 0, 0, 0, 0, 0, 0, 0, 0, 0, 0, 0, 0, 1, 0, 0, 1, 0, 0,
            0, 0, 0, 0, 0, 0, 0, 0, 0, 0, 0, 0, 0, 0, 0, 0, 0, 0, 0, 1, 1, 0, 1, 0, 0,
            0, 0, 0, 0, 0, 0, 0, 0, 0, 0, 0, 0, 0, 0, 0, 0, 0, 0, 0, 0, 1, 0, 1, 0, 0,
            0, 0, 0, 0, 0, 0, 0, 0, 0, 0, 0, 0, 0, 0, 0, 0, 0, 0, 0, 0, 0, 0, 1, 0, 0,
            0, 0, 0, 0, 0, 0, 0, 0, 0, 0, 0, 0, 0, 0, 0, 0, 0, 0, 0, 0, 0, 0, 1, 0, 0,
            0, 1, 1, 0, 0, 0, 0, 0, 0, 0, 0, 0, 0, 0, 0, 0, 0, 0, 0, 0, 0, 0, 0, 0, 0,
            0, 1, 0, 0, 0, 0, 0, 0, 0, 0, 0, 0, 0, 0, 0, 0, 0, 0, 0, 0, 0, 1, 0, 0, 0,
            0, 1, 0, 0, 0, 0, 0, 0, 0, 0, 0, 0, 0, 0, 0, 0, 0, 0, 0, 0, 0, 1, 0, 1, 1,
            0, 0, 0, 0, 0, 0, 0, 0, 0, 0, 0, 0, 0, 0, 0, 0, 0, 0, 0, 0, 1, 1, 0, 0, 1,	
            0, 0, 1, 1, 1, 1, 1, 1, 1, 1, 1, 1, 1, 0, 0, 0, 0, 0, 0, 1, 1, 0, 0, 0, 1,
            0, 0, 0, 5, 5, 5, 5, 5, 5, 5, 5, 5, 0, 0, 0, 0, 0, 0, 1, 1, 0, 0, 0, 0, 0,
            0, 0, 6, 5, 5, 5, 5, 5, 5, 5, 5, 5, 0, 0, 0, 1, 0, 0, 1, 0, 0, 0, 0, 0, 0,
            0, 0, 5, 5, 5, 5, 5, 5, 5, 5, 5, 5, 5, 9, 0, 1, 0, 0, 1, 0, 0, 0, 0, 0, 0,
            0, 0, 7, 5, 5, 5, 5, 5, 5, 5, 5, 5, 5, 5, 0, 1, 1, 0, 0, 0, 0, 0, 0, 0, 0,
            0, 0, 0, 7, 5, 5, 5, 5, 5, 5, 5, 5, 5, 8, 0, 0, 0, 0, 0, 0, 1, 1, 1, 0, 0,
            0, 0, 0, 0, 0, 0, 0, 0, 0, 0, 0, 0, 0, 0, 0, 0, 0, 0, 0, 0, 0, 0, 0, 0, 0


            150, 150, 150, 150, 150, 150, 150, 150, 150, 150, 150, 150, 150, 150, 150, 150, 150, 150, 150, 150, 150, 150, 150, 150, 150,
            150, 150, 150, 150, 150, 150, 150, 150, 150, 150, 150, 150, 150, 150, 150, 150, 150, 150, 150, 150, 150, 16, 150, 150, 150,
            150, 150, 150, 150, 150, 16, 150, 150, 150, 150, 150, 150, 150, 16, 150, 150, 150, 150, 150, 150, 17, 20, 15, 150, 150,
            150, 150, 150, 150, 17, 20, 15, 150, 150, 150, 150, 150, 17, 20, 15, 150, 150, 150, 150, 150, 18, 21, 14, 150, 150,
            150, 150, 150, 150, 18, 21, 14, 150, 150, 150, 150, 150, 18, 21, 14, 150, 150, 150, 150, 150, 19, 12, 13, 150, 150,
            150, 150, 150, 150, 19, 12, 13, 150, 150, 150, 16, 150, 19, 12, 13, 150, 150, 150, 16, 150, 28, 29, 30, 150, 150,
            150, 150, 150, 150, 28, 29, 30, 150, 150, 17, 20, 15, 28, 29, 30, 150, 150, 17, 20, 15, 150, 150, 150, 150, 150,
            150, 150, 150, 16, 150, 150, 150, 150, 150, 18, 21, 14, 150, 150, 150, 150, 150, 18, 21, 14, 150, 150, 150, 150, 150,
            150, 150, 17, 20, 15, 150, 150, 150, 150, 19, 12, 13, 150, 150, 150, 150, 150, 19, 12, 13, 150, 150, 150, 150, 150,
            150, 150, 18, 21, 14, 150, 150, 150, 150, 28, 29, 30, 150, 150, 150, 150, 150, 28, 29, 30, 150, 150, 150, 150, 150,
            150, 150, 19, 12, 13, 150, 150, 150, 150, 150, 150, 150, 150, 150, 16, 150, 150, 150, 150, 150, 150, 150, 150, 150, 150,
            150, 150, 28, 29, 30, 150, 150, 150, 150, 150, 150, 150, 150, 17, 20, 15, 150, 150, 150, 150, 150, 150, 150, 150, 150,
            150, 150, 150, 150, 150, 150, 150, 150, 150, 150, 150, 150, 150, 18, 21, 14, 150, 150, 150, 150, 150, 150, 150, 150, 150,
            150, 150, 150, 150, 150, 16, 150, 150, 150, 150, 150, 150, 150, 19, 12, 13, 150, 150, 150, 150, 150, 150, 150, 150, 150,
            150, 150, 150, 150, 17, 20, 15, 150, 150, 150, 150, 150, 150, 28, 29, 30, 150, 150, 150, 150, 150, 150, 150, 150, 150,
            150, 150, 150, 150, 18, 21, 14, 150, 150, 150, 150, 150, 150, 150, 150, 150, 150, 150, 150, 150, 150, 150, 150, 150, 150,
            150, 150, 150, 150, 19, 12, 13, 150, 150, 150, 150, 150, 150, 150, 150, 150, 150, 150, 150, 150, 150, 150, 150, 150, 150,
            150, 150, 150, 150, 28, 29, 30, 150, 150, 150, 150, 150, 150, 150, 150, 150, 16, 150, 150, 150, 150, 150, 150, 150, 150,
            150, 150, 150, 150, 150, 150, 150, 150, 150, 150, 150, 150, 150, 150, 150, 17, 20, 15, 150, 150, 150, 150, 16, 150, 150,
            150, 150, 150, 150, 150, 150, 150, 150, 150, 150, 150, 150, 150, 150, 150, 18, 21, 14, 150, 150, 150, 17, 20, 15, 150,
            150, 150, 150, 150, 150, 150, 150, 150, 150, 150, 150, 150, 150, 150, 150, 19, 12, 13, 150, 150, 150, 18, 21, 14, 150,
            150, 150, 150, 150, 150, 150, 150, 150, 150, 150, 150, 150, 150, 150, 150, 28, 29, 30, 150, 150, 150, 19, 12, 13, 150,
            150, 150, 150, 150, 150, 150, 150, 150, 150, 150, 150, 150, 150, 150, 150, 150, 150, 150, 150, 150, 150, 28, 29, 30, 150,
            150, 150, 150, 150, 150, 150, 150, 150, 150, 150, 150, 150, 150, 150, 150, 150, 150, 150, 150, 150, 150, 150, 150, 150, 150,
            150, 150, 150, 150, 150, 150, 150, 150, 150, 150, 150, 150, 150, 150, 150, 150, 150, 150, 150, 150, 150, 150, 150, 150, 150
            
            150, 150, 150, 150, 150, 150, 150, 150, 150, 150, 150, 150, 150, 150, 150, 150, 150, 150, 150, 150, 150, 150, 150, 150, 150,
            150, 150, 150, 150, 150, 150, 150, 150, 150, 150, 150, 150, 150, 150, 150, 150, 150, 150, 150, 150, 150, 150, 150, 150, 150,
            150, 150, 150, 150, 150, 150, 150, 150, 150, 150, 150, 150, 150, 150, 150, 150, 150, 150, 150, 150, 150, 150, 150, 150, 150,
            150, 150, 150, 150, 150, 150, 150, 150, 150, 150, 150, 150, 150, 150, 150, 150, 150, 150, 150, 150, 150, 150, 150, 150, 150,
            150, 150, 150, 150, 150, 150, 150, 150, 150, 150, 150, 150, 150, 150, 150, 150, 150, 150, 150, 150, 150, 150, 150, 150, 150,
            150, 150, 150, 150, 150, 150, 150, 150, 150, 150, 150, 150, 150, 150, 150, 150, 150, 150, 150, 150, 150, 150, 150, 150, 150,
            150, 150, 150, 150, 150, 150, 150, 150, 150, 150, 150, 150, 150, 150, 150, 150, 150, 150, 150, 150, 150, 150, 150, 150, 150,
            150, 150, 150, 150, 150, 150, 150, 150, 150, 150, 150, 150, 150, 150, 150, 150, 150, 150, 150, 150, 150, 150, 150, 150, 150,
            150, 150, 150, 150, 150, 150, 150, 150, 150, 150, 150, 150, 150, 150, 150, 150, 150, 150, 150, 150, 150, 150, 150, 150, 150,
            150, 150, 150, 150, 150, 150, 150, 150, 150, 150, 150, 150, 150, 150, 150, 150, 150, 150, 150, 150, 150, 150, 150, 150, 150,
            150, 150, 150, 150, 150, 150, 150, 150, 150, 150, 150, 150, 150, 150, 150, 150, 150, 150, 150, 150, 150, 150, 150, 150, 150,
            150, 150, 150, 150, 150, 150, 150, 150, 150, 150, 150, 150, 150, 150, 150, 150, 150, 150, 150, 150, 150, 150, 150, 150, 150,
            150, 150, 150, 150, 150, 150, 150, 150, 150, 150, 150, 150, 150, 150, 150, 150, 150, 150, 150, 150, 150, 150, 150, 150, 150,
            150, 150, 150, 150, 150, 150, 150, 150, 150, 150, 150, 150, 150, 150, 150, 150, 150, 150, 150, 150, 150, 150, 150, 150, 150,
            150, 150, 150, 150, 150, 150, 150, 31, 32, 33, 34, 35, 36, 150, 150, 150, 150, 150, 150, 150, 150, 150, 150, 150, 150,
            150, 150, 150, 150, 150, 150, 150, 37, 38, 39, 40, 41, 42, 150, 150, 150, 150, 150, 150, 150, 150, 150, 150, 150, 150,
            150, 150, 150, 150, 150, 150, 150, 43, 44, 45, 46, 47, 48, 150, 150, 150, 150, 150, 150, 150, 150, 150, 150, 150, 150,
            150, 150, 150, 150, 150, 150, 150, 150, 150, 150, 150, 150, 150, 150, 150, 150, 150, 150, 150, 150, 150, 150, 150, 150, 150,
            150, 150, 150, 150, 150, 150, 150, 150, 150, 150, 150, 150, 150, 150, 150, 150, 150, 150, 150, 150, 150, 150, 150, 150, 150,
            150, 150, 150, 150, 150, 150, 150, 150, 150, 150, 150, 150, 150, 150, 150, 150, 150, 150, 150, 150, 150, 150, 150, 150, 150,
            150, 150, 150, 150, 150, 150, 150, 150, 150, 150, 150, 150, 150, 150, 150, 150, 150, 150, 150, 150, 150, 150, 150, 150, 150,
            150, 150, 150, 150, 150, 150, 150, 150, 150, 150, 150, 150, 150, 150, 150, 150, 150, 150, 150, 150, 150, 150, 150, 150, 150,
            150, 150, 150, 150, 150, 150, 150, 150, 150, 150, 150, 150, 150, 150, 150, 150, 150, 150, 150, 150, 150, 150, 150, 150, 150,
            150, 150, 150, 150, 150, 150, 150, 150, 150, 150, 150, 150, 150, 150, 150, 150, 150, 150, 150, 150, 150, 150, 150, 150, 150,
            150, 150, 150, 150, 150, 150, 150, 150, 150, 150, 150, 150, 150, 150, 150, 150, 150, 150, 150, 150, 150, 150, 150, 150, 150
            
            150, 150, 150, 150, 150, 150, 150, 150, 150, 150, 150, 150, 150, 150, 150, 150, 150, 150, 150, 150, 150, 150, 150, 150, 150,
            150, 150, 150, 150, 150, 150, 150, 150, 150, 150, 150, 150, 150, 150, 150, 150, 150, 150, 150, 150, 150, 150, 150, 150, 150,
            150, 150, 150, 150, 150, 150, 150, 150, 150, 150, 150, 150, 150, 150, 150, 150, 150, 150, 150, 150, 150, 150, 150, 150, 150,
            150, 150, 150, 150, 150, 150, 150, 150, 150, 150, 150, 150, 150, 150, 150, 150, 150, 150, 150, 150, 150, 150, 150, 150, 150,
            150, 150, 150, 150, 150, 150, 150, 150, 150, 150, 150, 150, 150, 150, 150, 150, 150, 150, 150, 150, 150, 150, 150, 150, 150,
            150, 150, 150, 150, 150, 150, 150, 150, 150, 150, 150, 150, 150, 150, 150, 150, 150, 150, 150, 150, 150, 150, 150, 150, 150,
            150, 150, 150, 150, 150, 150, 150, 150, 150, 150, 150, 150, 150, 150, 150, 150, 150, 150, 150, 150, 150, 150, 150, 150, 150,
            150, 150, 150, 150, 150, 150, 150, 50, 51, 52, 53, 54, 55, 150, 150, 150, 150, 150, 150, 150, 150, 150, 150, 150, 150,
            150, 150, 150, 150, 150, 150, 150, 56, 57, 58, 59, 60, 61, 150, 150, 150, 150, 150, 150, 150, 150, 150, 150, 150, 150,
            150, 150, 150, 150, 150, 150, 150, 62, 63, 64, 65, 66, 67, 150, 150, 150, 150, 150, 150, 150, 150, 150, 150, 150, 150,
            150, 150, 150, 150, 150, 150, 150, 68, 69, 70, 71, 72, 73, 150, 150, 150, 150, 150, 150, 150, 150, 150, 150, 150, 150,
            150, 150, 150, 150, 150, 150, 150, 74, 75, 76, 77, 78, 79, 150, 150, 150, 150, 150, 150, 150, 150, 150, 150, 150, 150,
            150, 150, 150, 150, 150, 150, 150, 80, 81, 82, 83, 84, 85, 150, 150, 150, 150, 150, 150, 150, 150, 150, 150, 150, 150,
            150, 150, 150, 150, 150, 150, 150, 86, 87, 88, 89, 90, 91, 150, 150, 150, 150, 150, 150, 150, 150, 150, 150, 150, 150,
            150, 150, 150, 150, 150, 150, 150, 92, 93, 94, 95, 96, 97, 150, 150, 150, 150, 150, 150, 150, 150, 150, 150, 150, 150,
            150, 150, 150, 150, 150, 150, 150, 150, 150, 150, 150, 150, 150, 150, 150, 150, 150, 150, 150, 150, 150, 150, 150, 150, 150,
            150, 150, 150, 150, 150, 150, 150, 150, 150, 150, 150, 150, 150, 150, 150, 150, 150, 150, 150, 150, 150, 150, 150, 150, 150,
            150, 150, 150, 150, 150, 150, 150, 150, 150, 150, 150, 150, 150, 150, 150, 150, 150, 150, 150, 150, 150, 150, 150, 150, 150,
            150, 150, 150, 150, 150, 150, 150, 150, 150, 150, 150, 150, 150, 150, 150, 150, 150, 150, 150, 150, 150, 150, 150, 150, 150,
            150, 150, 150, 150, 150, 150, 150, 150, 150, 150, 150, 150, 150, 150, 150, 150, 150, 150, 150, 150, 150, 150, 150, 150, 150,
            150, 150, 150, 150, 150, 150, 150, 150, 150, 150, 150, 150, 150, 150, 150, 150, 150, 150, 150, 150, 150, 150, 150, 150, 150,
            150, 150, 150, 150, 150, 150, 150, 150, 150, 150, 150, 150, 150, 150, 150, 150, 150, 150, 150, 150, 150, 150, 150, 150, 150,
            150, 150, 150, 150, 150, 150, 150, 150, 150, 150, 150, 150, 150, 150, 150, 150, 150, 150, 150, 150, 150, 150, 150, 150, 150,
            150, 150, 150, 150, 150, 150, 150, 150, 150, 150, 150, 150, 150, 150, 150, 150, 150, 150, 150, 150, 150, 150, 150, 150, 150,
            150, 150, 150, 150, 150, 150, 150, 150, 150, 150, 150, 150, 150, 150, 150, 150, 150, 150, 150, 150, 150, 150, 150, 150, 150
            
            
            
            
            
            
            
            