            0, 0, 0, 0, 0, 0, 0, 11, 11, 11, 0, 0, 0, 0, 0, 0, 0, 0, 11, 11, 11, 0, 0, 0, 0,
            0, 0, 0, 0, 0, 0, 0, 0, 11, 0, 0, 0, 0, 0, 0, 0, 0, 0, 0, 11, 0, 0, 0, 0, 0,
            0, 0, 0, 0, 0, 0, 0, 0, 11, 0, 0, 0, 0, 0, 0, 0, 0, 0, 0, 11, 0, 0, 0, 0, 0,
            0, 0, 0, 0, 0, 0, 11, 11, 11, 0, 0, 0, 0, 0, 0, 0, 0, 0, 0, 11, 0, 0, 0, 0, 0,
            0, 0, 0, 0, 0, 0, 11, 0, 0, 149, 0, 0, 0, 0, 0, 0, 0, 0, 0, 11, 0, 0, 0, 0, 0,
            0, 0, 0, 0, 0, 0, 11, 0, 0, 0, 0, 0, 0, 0, 0, 0, 149, 0, 0, 11, 0, 0, 0, 0, 0,
            0, 0, 0, 0, 0, 0, 11, 0, 0, 0, 0, 0, 0, 0, 0, 0, 0, 0, 0, 11, 0, 0, 0, 0, 0,
            0, 0, 0, 0, 0, 0, 11, 0, 0, 0, 0, 0, 0, 0, 0, 0, 0, 0, 0, 11, 0, 0, 0, 0, 0,
            0, 0, 149, 0, 0, 0, 11, 0, 0, 0, 0, 0, 0, 0, 0, 0, 0, 0, 0, 11, 0, 0, 0, 0, 0,
            0, 0, 0, 0, 0, 0, 11, 0, 0, 0, 0, 0, 0, 0, 0, 0, 0, 0, 0, 11, 0, 0, 0, 0, 0,
            0, 0, 0, 0, 0, 0, 11, 0, 0, 0, 0, 0, 0, 0, 0, 11, 11, 11, 11, 11, 0, 0, 0, 0, 149,
            0, 0, 0, 0, 0, 0, 11, 0, 0, 0, 0, 0, 0, 0, 0, 11, 0, 0, 0, 0, 0, 0, 0, 0, 0,
            0, 11, 11, 11, 11, 11, 11, 0, 0, 149, 0, 0, 0, 0, 0, 11, 0, 0, 0, 0, 0, 0, 0, 0, 0,
            0, 11, 0, 0, 0, 0, 0, 0, 0, 0, 0, 0, 0, 0, 0, 11, 0, 0, 0, 0, 0, 0, 0, 0, 0,
            0, 11, 0, 0, 0, 0, 0, 0, 0, 0, 0, 0, 0, 0, 0, 11, 0, 0, 0, 0, 0, 0, 0, 0, 0,
            0, 11, 0, 0, 0, 0, 0, 0, 0, 0, 0, 0, 0, 0, 0, 11, 0, 0, 0, 0, 0, 0, 0, 0, 0,
            0, 11, 0, 0, 0, 0, 0, 0, 0, 11, 11, 11, 11, 11, 11, 11, 0, 0, 0, 0, 0, 0, 0, 0, 0,
            0, 11, 149, 0, 0, 0, 0, 0, 0, 11, 0, 0, 0, 0, 0, 0, 0, 0, 0, 0, 0, 0, 0, 0, 0,
            0, 11, 0, 0, 0, 0, 0, 0, 0, 11, 0, 0, 0, 0, 0, 0, 6, 5, 5, 5, 5, 5, 9, 0, 0,
            0, 11, 0, 0, 0, 0, 0, 0, 0, 11, 0, 0, 0, 0, 0, 0, 5, 5, 5, 5, 5, 5, 5, 0, 0,
            0, 11, 11, 11, 11, 11, 11, 11, 11, 11, 0, 0, 0, 0, 0, 0, 5, 5, 5, 5, 5, 5, 5, 0, 0,
            0, 0, 0, 0, 0, 0, 0, 0, 0, 11, 0, 0, 0, 0, 0, 0, 7, 5, 5, 5, 5, 5, 8, 0, 0,
            0, 0, 0, 0, 0, 0, 0, 0, 0, 11, 0, 0, 0, 0, 0, 0, 0, 0, 0, 0, 0, 0, 0, 0, 0,
            0, 0, 0, 0, 0, 0, 0, 11, 11, 11, 11, 11, 0, 0, 0, 0, 0, 0, 0, 0, 0, 0, 0, 0, 0,
            0, 0, 0, 0, 0, 0, 0, 11, 11, 11, 11, 11, 0, 0, 0, 0, 0, 0, 0, 0, 0, 0, 0, 0, 0
            
            150, 10, 150, 150, 150, 150, 150, 150, 150, 150, 150, 150, 150, 150, 150, 150, 150, 150, 150, 150, 150, 150, 150, 150, 150,
            150, 10, 10, 150, 150, 150, 150, 150, 150, 150, 150, 150, 150, 150, 150, 150, 150, 150, 150, 150, 150, 150, 150, 150, 150,
            150, 10, 10, 150, 150, 150, 150, 150, 150, 150, 150, 150, 150, 150, 150, 150, 150, 150, 150, 150, 150, 150, 150, 150, 150,
            150, 150, 150, 150, 150, 150, 150, 150, 150, 150, 150, 150, 150, 150, 150, 150, 150, 150, 150, 150, 150, 150, 150, 150, 150,
            150, 150, 150, 150, 10, 150, 150, 150, 150, 149, 150, 150, 150, 150, 150, 150, 150, 150, 150, 150, 150, 150, 150, 150, 150,
            150, 150, 10, 10, 150, 150, 150, 150, 150, 150, 150, 150, 150, 150, 150, 150, 149, 150, 150, 150, 150, 150, 150, 150, 150,
            150, 150, 150, 150, 150, 150, 150, 150, 150, 150, 150, 150, 150, 10, 10, 150, 150, 150, 150, 150, 150, 150, 150, 150, 150,
            150, 150, 150, 150, 150, 150, 150, 150, 150, 150, 150, 150, 10, 10, 150, 150, 150, 150, 150, 150, 150, 150, 150, 150, 150,
            150, 150, 149, 150, 150, 150, 150, 150, 150, 150, 150, 10, 10, 10, 150, 150, 150, 150, 150, 150, 150, 150, 150, 150, 150,
            150, 150, 150, 150, 150, 150, 150, 150, 150, 150, 150, 150, 150, 10, 150, 150, 150, 150, 150, 150, 150, 150, 150, 150, 150,
            150, 150, 150, 150, 150, 150, 150, 150, 150, 150, 150, 150, 150, 150, 150, 150, 150, 150, 150, 150, 150, 150, 150, 150, 149,
            150, 150, 150, 150, 150, 150, 150, 150, 150, 150, 150, 150, 150, 150, 150, 150, 150, 150, 150, 150, 150, 150, 150, 150, 150,
            150, 150, 150, 150, 150, 150, 150, 150, 150, 149, 150, 150, 150, 150, 150, 150, 150, 150, 150, 150, 150, 150, 150, 150, 150,
            150, 150, 150, 150, 150, 150, 150, 150, 150, 150, 150, 150, 150, 150, 150, 150, 150, 150, 150, 150, 150, 150, 10, 10, 150,
            150, 150, 150, 150, 150, 150, 150, 150, 10, 10, 150, 150, 150, 150, 150, 150, 150, 150, 150, 150, 150, 10, 10, 10, 150,
            150, 150, 150, 150, 150, 150, 10, 10, 10, 150, 150, 150, 150, 150, 150, 150, 150, 150, 150, 150, 10, 10, 10, 150, 150,
            150, 150, 150, 150, 150, 150, 10, 10, 150, 150, 150, 150, 150, 150, 150, 150, 150, 150, 150, 10, 10, 150, 150, 150, 150,
            150, 150, 149, 150, 150, 150, 150, 10, 150, 150, 150, 150, 150, 150, 150, 150, 150, 150, 150, 150, 150, 150, 150, 150, 150,
            150, 150, 150, 150, 150, 150, 150, 150, 150, 150, 150, 150, 150, 150, 150, 150, 6, 150, 150, 150, 150, 150, 150, 150, 150,
            150, 150, 150, 150, 150, 150, 150, 150, 150, 150, 150, 150, 150, 150, 150, 150, 150, 150, 150, 150, 150, 150, 150, 150, 150,
            150, 150, 150, 150, 150, 150, 150, 150, 150, 150, 150, 150, 150, 150, 150, 150, 150, 150, 150, 150, 150, 150, 150, 150, 150,
            150, 150, 150, 10, 150, 150, 150, 150, 150, 150, 150, 150, 150, 150, 150, 150, 150, 150, 150, 150, 150, 150, 150, 150, 150,
            10, 10, 10, 150, 150, 150, 150, 150, 150, 150, 150, 150, 150, 150, 150, 150, 150, 150, 150, 150, 150, 150, 150, 150, 150,
            10, 10, 10, 150, 150, 150, 150, 150, 150, 150, 150, 150, 150, 10, 150, 150, 150, 150, 150, 150, 150, 150, 150, 150, 150,
            150, 10, 150, 150, 150, 150, 150, 150, 150, 150, 150, 150, 150, 10, 10, 150, 150, 150, 150, 150, 150, 150, 150, 150, 150
            
            150, 150, 150, 150, 150, 150, 150, 150, 150, 150, 150, 150, 150, 150, 150, 150, 150, 150, 150, 150, 150, 150, 150, 150, 150,
            150, 150, 150, 150, 150, 150, 150, 150, 150, 16, 150, 150, 150, 150, 150, 150, 150, 150, 150, 150, 150, 150, 150, 150, 150,
            150, 150, 150, 150, 150, 150, 150, 150, 17, 20, 15, 150, 150, 150, 150, 150, 16, 150, 150, 150, 150, 150, 150, 150, 150,
            150, 150, 150, 150, 150, 150, 150, 150, 18, 21, 14, 150, 150, 150, 150, 17, 20, 15, 150, 150, 150, 150, 150, 150, 150,
            150, 150, 150, 150, 150, 150, 150, 150, 19, 12, 13, 150, 150, 150, 150, 18, 21, 14, 150, 150, 150, 150, 150, 150, 150,
            150, 150, 16, 150, 150, 150, 150, 150, 28, 29, 30, 150, 150, 150, 150, 19, 12, 13, 150, 150, 150, 150, 150, 150, 150,
            150, 17, 20, 15, 150, 150, 150, 150, 150, 150, 150, 150, 150, 150, 150, 28, 29, 30, 150, 150, 150, 150, 150, 150, 150,
            150, 18, 21, 14, 150, 150, 150, 150, 150, 150, 150, 150, 150, 150, 150, 150, 150, 150, 150, 150, 150, 150, 150, 150, 16,
            150, 19, 12, 13, 150, 150, 150, 150, 150, 150, 150, 150, 150, 150, 150, 150, 150, 150, 150, 150, 150, 150, 150, 17, 20,
            150, 28, 29, 30, 150, 150, 150, 150, 150, 16, 150, 150, 150, 150, 150, 150, 150, 150, 150, 150, 150, 150, 150, 18, 21,
            150, 150, 150, 150, 150, 150, 150, 150, 17, 20, 15, 150, 150, 150, 150, 150, 150, 150, 150, 150, 150, 150, 150, 19, 12,
            150, 150, 150, 150, 150, 150, 150, 150, 18, 21, 14, 150, 150, 150, 150, 150, 150, 150, 150, 150, 150, 150, 150, 28, 29,
            150, 150, 150, 150, 150, 150, 150, 150, 19, 12, 13, 150, 150, 150, 150, 150, 150, 150, 150, 150, 150, 150, 150, 150, 150,
            150, 150, 150, 150, 150, 150, 150, 150, 28, 29, 30, 150, 150, 150, 150, 150, 150, 150, 150, 150, 150, 150, 150, 150, 150,
            150, 150, 16, 150, 150, 150, 150, 150, 150, 150, 150, 150, 150, 150, 150, 150, 150, 150, 150, 150, 150, 150, 150, 150, 150,
            150, 17, 20, 15, 150, 150, 150, 150, 150, 150, 150, 150, 150, 150, 150, 150, 150, 150, 150, 150, 150, 150, 150, 150, 150,
            150, 18, 21, 14, 150, 150, 150, 150, 150, 150, 150, 150, 150, 150, 150, 150, 150, 150, 150, 150, 150, 150, 150, 150, 150,
            150, 19, 12, 13, 150, 150, 150, 150, 150, 150, 150, 150, 150, 150, 150, 150, 150, 150, 150, 150, 150, 150, 150, 150, 150,
            150, 28, 29, 30, 150, 150, 150, 150, 150, 150, 150, 150, 150, 150, 150, 150, 150, 150, 150, 22, 150, 150, 150, 150, 150,
            150, 150, 150, 150, 150, 150, 150, 150, 150, 150, 150, 150, 150, 150, 150, 150, 150, 150, 22, 22, 150, 150, 150, 150, 150,
            150, 150, 150, 150, 150, 150, 150, 150, 150, 150, 150, 150, 150, 150, 150, 150, 150, 150, 22, 22, 22, 150, 150, 150, 150,
            150, 150, 150, 150, 150, 150, 150, 150, 150, 150, 150, 150, 150, 150, 150, 150, 150, 150, 150, 22, 150, 150, 150, 150, 150,
            150, 150, 150, 150, 150, 150, 150, 150, 150, 150, 150, 150, 150, 150, 150, 150, 150, 150, 150, 150, 150, 150, 150, 150, 150,
            150, 150, 150, 150, 150, 150, 150, 150, 150, 150, 150, 150, 150, 150, 150, 150, 150, 150, 150, 150, 150, 150, 150, 150, 150,
            150, 150, 150, 150, 150, 150, 150, 150, 150, 150, 150, 150, 150, 150, 150, 150, 150, 150, 150, 150, 150, 150, 150, 150, 150, 