            0, 0, 0, 0, 0, 0, 0, 0, 0, 0, 11, 0, 0, 0, 0, 0, 0, 0, 0, 0, 0, 0, 0, 0, 0,
            0, 0, 0, 0, 0, 0, 0, 0, 0, 0, 11, 0, 0, 0, 0, 0, 0, 0, 0, 0, 0, 0, 0, 0, 0,
            0, 0, 0, 0, 0, 0, 0, 0, 0, 0, 11, 0, 0, 0, 0, 0, 0, 0, 0, 0, 0, 0, 0, 0, 0,
            0, 0, 0, 0, 0, 0, 0, 0, 0, 0, 11, 0, 0, 0, 0, 0, 0, 0, 0, 0, 0, 0, 0, 0, 0,
            0, 0, 0, 0, 0, 0, 0, 0, 0, 0, 11, 0, 0, 0, 0, 0, 0, 0, 0, 0, 149, 0, 0, 0, 0,
            0, 0, 0, 0, 0, 149, 0, 0, 0, 0, 11, 0, 0, 149, 0, 0, 0, 0, 0, 0, 0, 0, 0, 0, 0,
            0, 0, 0, 0, 0, 0, 0, 0, 0, 0, 11, 11, 11, 11, 0, 0, 0, 0, 0, 0, 0, 0, 0, 0, 0,
            0, 0, 0, 0, 0, 0, 0, 0, 0, 0, 0, 0, 0, 11, 0, 0, 0, 0, 0, 0, 0, 0, 0, 0, 0,
            0, 0, 0, 0, 0, 0, 0, 0, 0, 0, 149, 0, 0, 11, 11, 11, 11, 11, 149, 0, 0, 0, 0, 0, 0,
            0, 0, 0, 0, 0, 0, 0, 0, 0, 0, 0, 0, 0, 0, 0, 0, 0, 11, 0, 0, 0, 0, 0, 0, 0,
            0, 0, 0, 149, 0, 0, 0, 0, 0, 0, 0, 0, 0, 0, 0, 0, 0, 11, 0, 0, 0, 0, 0, 0, 0,
            0, 0, 0, 0, 0, 0, 0, 0, 0, 0, 0, 0, 0, 0, 0, 0, 0, 11, 0, 0, 0, 0, 0, 0, 0,
            0, 0, 0, 0, 0, 0, 0, 0, 0, 0, 0, 0, 0, 0, 0, 0, 0, 11, 0, 0, 0, 0, 0, 0, 0,
            0, 0, 0, 0, 0, 0, 0, 0, 0, 0, 0, 0, 0, 0, 149, 0, 0, 11, 0, 0, 0, 0, 0, 0, 0,
            0, 0, 0, 0, 0, 0, 0, 0, 0, 0, 0, 0, 0, 0, 0, 0, 0, 11, 0, 0, 0, 0, 0, 0, 0,
            0, 0, 0, 0, 0, 0, 0, 0, 0, 0, 0, 0, 0, 11, 11, 11, 11, 11, 0, 0, 0, 0, 0, 0, 0,
            0, 0, 0, 0, 0, 149, 0, 0, 0, 0, 11, 11, 11, 11, 0, 0, 0, 0, 0, 0, 0, 0, 0, 0, 0,
            0, 0, 0, 0, 0, 0, 0, 0, 0, 0, 0, 0, 0, 0, 0, 0, 0, 0, 0, 0, 0, 0, 0, 0, 0,
            0, 0, 1, 1, 1, 1, 1, 1, 1, 1, 1, 1, 1, 0, 0, 0, 0, 0, 0, 1, 1, 0, 0, 0, 1,
            0, 0, 0, 5, 5, 5, 5, 5, 5, 5, 5, 5, 0, 0, 0, 0, 0, 0, 1, 1, 0, 0, 0, 0, 0,
            0, 0, 6, 5, 5, 5, 5, 5, 5, 5, 5, 5, 0, 0, 0, 1, 149, 0, 1, 0, 0, 0, 0, 0, 0,
            0, 0, 5, 5, 5, 5, 5, 5, 5, 5, 5, 5, 5, 0, 0, 1, 0, 0, 1, 0, 0, 0, 149, 0, 0,
            0, 0, 7, 5, 5, 5, 5, 5, 5, 5, 5, 5, 5, 5, 0, 1, 1, 0, 0, 0, 0, 0, 0, 0, 0,
            0, 0, 0, 7, 5, 5, 5, 5, 5, 5, 5, 5, 5, 8, 0, 0, 0, 0, 0, 0, 1, 1, 1, 0, 0,
            0, 0, 0, 0, 0, 0, 0, 0, 0, 0, 0, 0, 0, 0, 0, 0, 0, 0, 0, 0, 0, 0, 0, 0, 0
            
            150, 150, 150, 150, 150, 150, 150, 150, 150, 150, 150, 150, 150, 150, 150, 150, 150, 150, 150, 150, 150, 150, 150, 150, 150,
            150, 150, 150, 150, 150, 150, 150, 150, 150, 150, 150, 150, 150, 150, 150, 150, 150, 150, 150, 150, 150, 150, 150, 150, 150,
            150, 150, 150, 150, 150, 150, 150, 150, 150, 150, 150, 150, 150, 150, 150, 150, 150, 150, 150, 150, 150, 150, 150, 150, 150,
            150, 150, 150, 150, 150, 150, 150, 150, 150, 150, 150, 150, 150, 150, 150, 150, 150, 150, 150, 150, 150, 150, 150, 150, 150,
            150, 150, 150, 150, 150, 150, 150, 150, 150, 150, 150, 150, 150, 150, 150, 150, 150, 150, 150, 150, 150, 150, 150, 150, 150,
            150, 150, 150, 150, 150, 150, 150, 150, 150, 150, 150, 150, 150, 150, 150, 150, 150, 150, 150, 150, 150, 150, 150, 150, 150,
            150, 150, 150, 150, 150, 150, 150, 150, 150, 150, 150, 150, 150, 150, 150, 150, 150, 150, 150, 150, 150, 150, 150, 150, 150,
            150, 150, 150, 150, 150, 150, 150, 150, 150, 150, 150, 150, 150, 150, 150, 150, 150, 150, 150, 150, 150, 150, 150, 150, 150,
            150, 150, 150, 150, 150, 150, 150, 150, 150, 150, 150, 150, 150, 150, 150, 150, 150, 150, 150, 150, 150, 150, 150, 150, 150,
            150, 150, 150, 150, 150, 150, 150, 150, 150, 150, 150, 150, 150, 150, 150, 150, 150, 150, 150, 150, 150, 150, 150, 150, 150,
            150, 150, 150, 150, 150, 150, 150, 150, 150, 150, 150, 150, 150, 150, 150, 150, 150, 150, 150, 150, 150, 150, 150, 150, 150,
            150, 150, 150, 150, 150, 150, 150, 150, 150, 150, 150, 150, 150, 150, 150, 150, 150, 150, 150, 150, 150, 150, 150, 150, 150,
            150, 150, 150, 150, 150, 150, 150, 150, 150, 150, 150, 150, 150, 150, 150, 150, 150, 150, 150, 150, 150, 150, 150, 150, 150,
            150, 150, 150, 150, 150, 150, 150, 150, 150, 150, 150, 150, 150, 150, 150, 150, 150, 150, 150, 150, 150, 150, 150, 150, 150,
            150, 150, 150, 150, 150, 150, 150, 150, 150, 150, 150, 150, 150, 150, 150, 150, 150, 150, 150, 150, 150, 150, 150, 150, 150,
            150, 150, 150, 150, 150, 150, 150, 150, 150, 150, 150, 150, 150, 150, 150, 150, 150, 150, 150, 150, 150, 150, 150, 150, 150,
            150, 150, 150, 150, 150, 150, 150, 150, 150, 150, 150, 150, 150, 150, 150, 150, 150, 150, 150, 150, 150, 150, 150, 150, 150,
            150, 150, 150, 150, 150, 150, 150, 150, 150, 150, 150, 150, 150, 150, 150, 150, 150, 150, 150, 150, 150, 150, 150, 150, 150,
            150, 150, 150, 150, 150, 150, 150, 150, 150, 150, 150, 150, 150, 150, 150, 150, 150, 150, 150, 150, 150, 150, 150, 150, 150,
            150, 150, 150, 150, 150, 150, 150, 150, 150, 150, 150, 150, 150, 150, 150, 150, 150, 150, 150, 150, 150, 150, 150, 150, 150,
            150, 150, 150, 150, 150, 150, 150, 150, 150, 150, 150, 150, 150, 150, 150, 150, 150, 150, 150, 150, 150, 150, 150, 150, 150,
            150, 150, 150, 150, 150, 150, 150, 150, 150, 150, 150, 150, 150, 150, 150, 150, 150, 150, 150, 150, 150, 150, 150, 150, 150,
            150, 150, 150, 150, 150, 150, 150, 150, 150, 150, 150, 150, 150, 150, 150, 150, 150, 150, 150, 150, 150, 150, 150, 150, 150,
            150, 150, 150, 150, 150, 150, 150, 150, 150, 150, 150, 150, 150, 150, 150, 150, 150, 150, 150, 150, 150, 150, 150, 150, 150,
            150, 150, 150, 150, 150, 150, 150, 150, 150, 150, 150, 150, 150, 150, 150, 150, 150, 150, 150, 150, 150, 150, 150, 150, 150

            150, 150, 150, 150, 150, 150, 150, 150, 150, 150, 150, 150, 150, 150, 150, 150, 150, 150, 150, 150, 150, 150, 150, 150, 150,
            150, 150, 150, 150, 150, 150, 150, 150, 150, 150, 150, 150, 150, 150, 150, 150, 150, 150, 150, 150, 150, 16, 150, 150, 150,
            150, 150, 150, 150, 150, 16, 150, 150, 150, 150, 150, 150, 150, 16, 150, 150, 150, 150, 150, 150, 17, 20, 15, 150, 150,
            150, 150, 150, 150, 17, 20, 15, 150, 150, 150, 150, 150, 17, 20, 15, 150, 150, 150, 150, 150, 18, 21, 14, 150, 150,
            150, 150, 150, 150, 18, 21, 14, 150, 150, 150, 150, 150, 18, 21, 14, 150, 150, 150, 150, 150, 19, 12, 13, 150, 150,
            150, 150, 150, 150, 19, 12, 13, 150, 150, 150, 150, 150, 19, 12, 13, 150, 150, 150, 16, 150, 28, 29, 30, 150, 150,
            150, 150, 150, 150, 28, 29, 30, 150, 150, 150, 150, 150, 28, 29, 30, 150, 150, 17, 20, 15, 150, 150, 150, 150, 150,
            150, 150, 150, 16, 150, 150, 150, 150, 150, 79, 78, 150, 150, 150, 150, 150, 150, 18, 21, 14, 150, 150, 150, 150, 150,
            150, 150, 17, 20, 15, 150, 150, 150, 83, 80, 81, 82, 150, 150, 150, 150, 150, 19, 12, 13, 150, 150, 150, 150, 150,
            150, 150, 18, 21, 14, 150, 150, 73, 74, 75, 76, 77, 84, 150, 150, 150, 150, 28, 29, 30, 150, 150, 150, 150, 150,
            150, 150, 19, 12, 13, 150, 150, 67, 68, 69, 70, 71, 72, 150, 16, 150, 150, 150, 150, 150, 150, 150, 150, 150, 150,
            150, 150, 28, 29, 30, 150, 150, 61, 62, 63, 64, 65, 66, 17, 20, 15, 150, 150, 150, 150, 150, 150, 150, 150, 150,
            150, 150, 150, 150, 150, 150, 150, 55, 56, 57, 58, 59, 60, 18, 21, 14, 150, 150, 150, 150, 150, 150, 150, 150, 150,
            150, 150, 150, 150, 150, 16, 150, 49, 50, 51, 52, 53, 54, 19, 12, 13, 150, 150, 150, 150, 150, 150, 150, 150, 150,
            150, 150, 150, 150, 150, 20, 15, 31, 32, 33, 34, 35, 36, 28, 29, 30, 150, 150, 150, 150, 150, 150, 150, 150, 150,
            150, 150, 150, 150, 18, 21, 14, 37, 38, 39, 40, 41, 42, 150, 150, 150, 150, 150, 150, 150, 150, 150, 150, 150, 150,
            150, 150, 150, 150, 19, 12, 13, 43, 44, 45, 46, 47, 48, 150, 150, 150, 150, 150, 150, 150, 150, 150, 150, 150, 150,
            150, 150, 150, 150, 28, 29, 30, 150, 150, 150, 150, 150, 150, 150, 150, 150, 16, 150, 150, 150, 150, 150, 150, 150, 150,
            150, 150, 150, 150, 150, 150, 150, 150, 150, 150, 150, 150, 150, 150, 150, 17, 20, 15, 150, 150, 150, 150, 16, 150, 150,
            150, 150, 150, 150, 150, 150, 150, 150, 150, 150, 150, 150, 150, 150, 150, 18, 21, 14, 150, 150, 150, 17, 20, 15, 150,
            150, 150, 150, 150, 150, 150, 150, 150, 150, 150, 150, 150, 150, 150, 150, 19, 12, 13, 150, 150, 150, 18, 21, 14, 150,
            150, 150, 150, 150, 150, 150, 150, 150, 150, 150, 150, 150, 150, 150, 150, 28, 29, 30, 150, 150, 150, 19, 12, 13, 150,
            150, 150, 150, 150, 150, 150, 150, 150, 150, 150, 150, 150, 150, 150, 150, 150, 150, 150, 150, 150, 150, 28, 29, 30, 150,
            150, 150, 150, 150, 150, 150, 150, 150, 150, 150, 150, 150, 150, 150, 150, 150, 150, 150, 150, 150, 150, 150, 150, 150, 150,
            150, 150, 150, 150, 150, 150, 150, 150, 150, 150, 150, 150, 150, 150, 150, 150, 150, 150, 150, 150, 150, 150, 150, 150, 150
            

            
            
            
            
            
            
            
            
            