			0, 0, 0, 0, 0, 0, 0, 0, 0, 0, 0, 0, 0, 0, 0, 0, 0, 0, 0, 0, 0, 0, 0, 0, 0,
            0, 0, 0, 0, 0, 0, 0, 0, 0, 0, 0, 0, 0, 0, 0, 0, 0, 0, 0, 0, 0, 0, 0, 0, 0,
            0, 0, 0, 0, 0, 0, 0, 0, 0, 0, 0, 0, 0, 0, 0, 0, 0, 0, 0, 0, 0, 0, 0, 0, 0,
            0, 0, 0, 0, 0, 0, 0, 0, 0, 0, 0, 0, 149, 0, 0, 0, 0, 0, 0, 0, 0, 0, 0, 0, 0,
            0, 0, 0, 149, 0, 0, 0, 0, 0, 0, 0, 0, 0, 0, 0, 0, 0, 0, 149, 0, 0, 0, 0, 0, 0,
            0, 0, 0, 0, 0, 0, 0, 0, 0, 0, 0, 0, 0, 0, 0, 0, 0, 0, 0, 0, 0, 0, 0, 0, 0,
            0, 0, 0, 0, 0, 0, 0, 0, 0, 0, 0, 0, 0, 0, 0, 11, 11, 11, 11, 0, 0, 0, 0, 0, 0,
            0, 0, 0, 0, 0, 0, 0, 0, 0, 0, 0, 0, 0, 11, 11, 11, 11, 11, 11, 11, 11, 0, 0, 0, 0,
            0, 0, 0, 0, 0, 0, 149, 0, 11, 11, 11, 11, 11, 11, 11, 11, 11, 11, 11, 11, 11, 0, 0, 0, 0,
            0, 0, 0, 0, 0, 0, 0, 0, 11, 0, 0, 0, 0, 11, 11, 11, 11, 11, 11, 11, 11, 0, 0, 0, 0,
            0, 0, 0, 0, 0, 0, 0, 0, 11, 0, 0, 0, 0, 0, 0, 11, 11, 11, 11, 0, 0, 0, 0, 0, 0,
            0, 0, 0, 0, 0, 0, 0, 0, 11, 0, 0, 0, 0, 0, 0, 0, 0, 0, 0, 0, 0, 0, 0, 0, 0,
            0, 0, 0, 0, 0, 0, 0, 0, 11, 0, 0, 0, 0, 0, 0, 0, 0, 0, 0, 0, 0, 0, 0, 0, 0,
            0, 0, 0, 0, 0, 0, 0, 0, 11, 0, 0, 0, 0, 0, 0, 0, 0, 0, 0, 0, 0, 0, 149, 0, 0,
            0, 0, 0, 0, 0, 0, 0, 0, 11, 0, 0, 0, 0, 0, 0, 0, 0, 0, 0, 0, 0, 0, 0, 0, 0,
            0, 0, 0, 0, 0, 0, 0, 0, 11, 0, 0, 0, 0, 0, 0, 0, 0, 0, 0, 0, 0, 0, 0, 0, 0,
            0, 0, 0, 149, 0, 0, 0, 0, 11, 0, 0, 0, 0, 0, 0, 0, 0, 0, 0, 0, 0, 0, 0, 0, 0,
            0, 0, 0, 0, 0, 0, 0, 0, 11, 0, 0, 0, 0, 0, 0, 149, 0, 0, 0, 0, 0, 0, 0, 0, 0,
            0, 0, 0, 0, 0, 0, 0, 0, 11, 0, 0, 0, 0, 0, 0, 0, 0, 0, 0, 0, 0, 0, 0, 0, 0,
            0, 0, 0, 0, 0, 0, 0, 0, 11, 0, 0, 0, 0, 0, 0, 0, 0, 0, 0, 0, 0, 0, 0, 0, 0,
            0, 0, 0, 0, 0, 0, 0, 0, 11, 0, 0, 0, 0, 0, 0, 0, 0, 0, 0, 0, 0, 0, 0, 0, 0,
            0, 0, 0, 0, 0, 0, 0, 0, 11, 0, 0, 0, 0, 0, 0, 0, 0, 0, 0, 0, 0, 0, 0, 0, 0,
            0, 0, 0, 0, 0, 0, 0, 0, 11, 0, 0, 0, 0, 0, 0, 0, 0, 0, 0, 0, 0, 0, 0, 0, 0,
            0, 0, 0, 0, 0, 0, 0, 11, 11, 11, 0, 0, 0, 0, 0, 0, 0, 0, 0, 0, 149, 0, 0, 0, 0,
            0, 0, 0, 0, 0, 0, 11, 11, 11, 11, 11, 0, 0, 0, 0, 0, 0, 0, 0, 0, 0, 0, 0, 0, 0
         
         	150, 150, 150, 150, 150, 150, 150, 150, 150, 150, 150, 150, 150, 150, 150, 150, 150, 150, 150, 150, 150, 150, 150, 150, 150,
            150, 150, 150, 150, 10, 10, 10, 10, 150, 150, 150, 150, 150, 150, 150, 150, 150, 150, 150, 150, 150, 150, 150, 150, 150,
            150, 150, 150, 150, 150, 150, 150, 10, 150, 150, 150, 150, 150, 150, 150, 150, 150, 150, 150, 150, 150, 150, 10, 10, 150,
            150, 150, 150, 150, 150, 150, 150, 150, 10, 150, 150, 150, 150, 150, 150, 150, 150, 150, 150, 150, 150, 10, 10, 10, 150,
            150, 150, 150, 150, 150, 150, 10, 10, 150, 150, 150, 150, 150, 150, 150, 150, 150, 150, 150, 150, 150, 10, 10, 150, 150,
            150, 150, 150, 150, 150, 150, 150, 150, 150, 150, 150, 150, 150, 150, 150, 150, 150, 150, 150, 150, 150, 150, 150, 150, 150,
            150, 150, 150, 150, 150, 150, 150, 150, 150, 150, 150, 150, 150, 150, 150, 150, 150, 150, 150, 150, 150, 150, 150, 150, 150,
            150, 150, 150, 150, 150, 150, 150, 150, 150, 150, 150, 150, 150, 150, 150, 150, 150, 150, 150, 150, 150, 150, 150, 150, 150,
            150, 150, 150, 150, 150, 150, 150, 150, 150, 150, 150, 150, 150, 150, 150, 150, 150, 150, 150, 150, 150, 150, 150, 150, 150,
            150, 10, 10, 150, 150, 150, 150, 150, 150, 150, 150, 150, 150, 150, 150, 150, 150, 150, 150, 150, 150, 150, 150, 150, 150,
            150, 150, 10, 10, 150, 150, 150, 150, 150, 150, 150, 150, 150, 150, 150, 150, 150, 150, 150, 150, 150, 150, 150, 150, 150,
            150, 150, 150, 10, 10, 150, 150, 150, 150, 150, 150, 10, 150, 150, 150, 150, 150, 150, 150, 150, 150, 150, 150, 150, 150,
            150, 150, 150, 150, 10, 150, 150, 150, 150, 150, 150, 10, 10, 150, 150, 150, 150, 150, 150, 150, 150, 150, 150, 150, 150,
            150, 150, 150, 150, 150, 150, 150, 150, 150, 150, 10, 10, 10, 150, 150, 150, 150, 150, 150, 150, 150, 150, 150, 150, 150,
            150, 150, 150, 150, 150, 150, 150, 150, 150, 150, 150, 10, 150, 150, 150, 150, 150, 150, 150, 150, 150, 150, 150, 150, 150,
            150, 150, 150, 150, 150, 150, 150, 150, 150, 150, 150, 150, 150, 150, 150, 150, 150, 150, 150, 10, 150, 150, 150, 150, 150,
            150, 150, 150, 150, 150, 150, 150, 150, 150, 150, 150, 150, 150, 150, 150, 150, 150, 150, 150, 10, 10, 150, 150, 150, 150,
            150, 150, 150, 150, 150, 150, 150, 150, 150, 150, 150, 150, 150, 150, 150, 150, 150, 150, 150, 150, 10, 150, 150, 150, 150,
            150, 150, 150, 150, 150, 150, 150, 150, 150, 150, 150, 150, 150, 150, 150, 150, 150, 150, 150, 150, 10, 10, 150, 150, 150,
            150, 150, 150, 150, 150, 150, 150, 150, 150, 150, 150, 150, 150, 150, 150, 150, 150, 150, 150, 150, 150, 150, 150, 150, 150,
            150, 150, 10, 10, 150, 150, 150, 150, 150, 150, 150, 10, 10, 10, 150, 150, 150, 150, 150, 150, 150, 150, 150, 150, 150,
            150, 150, 10, 10, 150, 150, 150, 150, 150, 150, 150, 150, 10, 10, 150, 150, 150, 150, 150, 150, 150, 150, 150, 150, 150,
            150, 150, 10, 10, 150, 150, 150, 150, 150, 150, 150, 150, 10, 10, 10, 150, 150, 150, 150, 150, 150, 150, 150, 150, 150,
            150, 150, 10, 150, 150, 150, 150, 150, 150, 150, 150, 150, 150, 150, 10, 10, 150, 150, 150, 150, 150, 150, 150, 150, 150,
            150, 150, 150, 150, 150, 150, 150, 150, 150, 150, 150, 150, 150, 150, 150, 150, 150, 150, 150, 150, 150, 150, 150, 150, 150
       
         	150, 150, 150, 150, 150, 150, 150, 150, 150, 150, 150, 150, 16, 150, 150, 150, 150, 150, 150, 150, 150, 150, 150, 150, 150,
            150, 150, 150, 16, 150, 150, 150, 150, 150, 150, 150, 17, 20, 15, 150, 150, 150, 150, 16, 150, 150, 150, 150, 150, 150,
            150, 150, 17, 20, 15, 150, 150, 150, 150, 150, 150, 18, 21, 14, 150, 150, 150, 17, 20, 15, 150, 150, 150, 150, 150,
            150, 150, 18, 21, 14, 150, 150, 150, 150, 150, 150, 19, 12, 13, 150, 150, 150, 18, 21, 14, 150, 150, 150, 150, 150,
            150, 150, 19, 12, 13, 150, 150, 150, 150, 150, 150, 28, 29, 30, 150, 150, 150, 19, 12, 13, 150, 150, 150, 150, 150,
            150, 150, 28, 29, 30, 150, 16, 150, 150, 150, 150, 150, 150, 150, 150, 150, 150, 28, 29, 30, 150, 150, 150, 150, 150,
            150, 150, 150, 150, 150, 17, 20, 15, 150, 150, 150, 150, 150, 150, 150, 150, 150, 150, 150, 150, 150, 150, 150, 150, 150,
            150, 150, 150, 150, 150, 18, 21, 14, 150, 150, 150, 150, 150, 150, 150, 150, 150, 150, 150, 150, 150, 150, 150, 150, 150,
            150, 150, 150, 150, 150, 19, 12, 13, 150, 150, 150, 150, 150, 150, 150, 150, 150, 150, 150, 150, 150, 150, 150, 150, 150,
            150, 150, 150, 150, 150, 28, 29, 30, 150, 150, 150, 150, 150, 150, 150, 150, 150, 150, 150, 150, 150, 150, 150, 150, 150,
            150, 150, 150, 150, 150, 150, 150, 150, 150, 150, 150, 150, 150, 150, 150, 150, 150, 150, 150, 150, 150, 150, 16, 150, 150,
            150, 150, 150, 150, 150, 150, 150, 150, 150, 150, 150, 150, 150, 150, 150, 150, 150, 150, 150, 150, 150, 17, 20, 15, 150,
            150, 150, 150, 150, 150, 150, 150, 150, 150, 150, 150, 150, 150, 150, 150, 150, 150, 150, 150, 150, 150, 18, 21, 14, 150,
            150, 150, 150, 16, 150, 150, 150, 150, 150, 150, 150, 150, 150, 150, 150, 150, 150, 150, 150, 150, 150, 19, 12, 13, 150,
            150, 150, 17, 20, 15, 150, 150, 150, 150, 150, 150, 150, 150, 150, 150, 16, 150, 150, 150, 150, 150, 28, 29, 30, 150,
            150, 150, 18, 21, 14, 150, 150, 150, 150, 150, 150, 150, 150, 150, 17, 20, 15, 150, 150, 150, 150, 150, 150, 150, 150,
            150, 150, 19, 12, 13, 150, 150, 150, 150, 150, 150, 150, 150, 150, 18, 21, 14, 150, 150, 150, 150, 150, 150, 150, 150,
            150, 150, 28, 29, 30, 150, 150, 150, 150, 150, 150, 150, 150, 150, 19, 12, 13, 150, 150, 150, 150, 150, 150, 150, 150,
            150, 150, 150, 150, 150, 150, 150, 150, 150, 150, 150, 150, 150, 150, 28, 29, 30, 150, 150, 150, 150, 150, 150, 150, 150,
            150, 150, 150, 150, 150, 150, 150, 150, 150, 150, 150, 150, 150, 150, 150, 150, 150, 150, 150, 150, 150, 150, 150, 150, 150,
            150, 150, 150, 150, 150, 150, 150, 150, 150, 150, 150, 150, 150, 150, 150, 150, 150, 150, 150, 150, 16, 150, 150, 150, 150,
            150, 150, 150, 150, 150, 150, 150, 150, 150, 150, 150, 150, 150, 150, 150, 150, 150, 150, 150, 17, 20, 15, 150, 150, 150,
            150, 150, 150, 150, 150, 150, 150, 150, 150, 150, 150, 150, 150, 150, 150, 150, 150, 150, 150, 18, 21, 14, 150, 150, 150,
            150, 150, 150, 150, 150, 150, 150, 150, 150, 150, 150, 150, 150, 150, 150, 150, 150, 150, 150, 19, 12, 13, 150, 150, 150,
            150, 150, 150, 150, 150, 150, 150, 150, 150, 150, 150, 150, 150, 150, 150, 150, 150, 150, 150, 28, 29, 30, 150, 150, 150
